####.####
###..####
###....#.
###.##...
###A##...
######...
#######..
###.##..#
........#
#...#####
##...####
##.######
##..#####
##.######
##B######
#########
